-----------------------                                                                   ---------                      -
-----------------------                                                                    -%%%%%-                       -
-----------------------                           --                                        -%%%-                        -
-----------------------                                                                      -%-                         -
-----------------------                --                                                     -                          -
------%----------------                                                                                                  -
-----------------------   --   --                                                                                        -
-----------------------                                                                                                  -
-----------------------                       ----     ---                                                               -
-----------%-----------                                              -       --                                          -
-----------------------   --                                                                                             -
-----------------------   -            --                                                                                -
-----------------------   -                            ---                                                               -
-----------------------   -     ------               -------                         --                                  -
---------%-------------   -                                                                  |                           -
-----------------------          ---                       -                                                             -
-----------------------                                    -                               ---------                     -
-----------------------       -------         ----         -                              -         -                    -
-------------      ----                                    -                             -           -                   -
                                                    -                                   -             -                  -
                                                                                       -               -                 -
---------------- -------------  ------------------------------------------------------------------------------------------