######################~^^^^^^^^^^^^^^^^^^^^^^^^^^^^^^^^^^^^^^
######################~^^^^^^^^^^^^^^^^^^^^^^^^^^^^^^^^^^^^^^
######################~^^^^^^^^^^^^^^^^^^^^^^^^^^^:$^^^^^^^^^
######################~^^^^^^^^^^^^^^^^^^^^^^^^^^^^^^^^^^^^^^
######################~^^^^^^^^^^^^^^^^:$^^^^^^^^^^^^^^^^^^^^
######################~^^^^^^^^^^^^^^^^^^^^^^^^^^^^^^^^^^^^^^
######################~^^^:$^^^:$^^^^^^^^^^^^^^^^^^^^^^^^^^^^
######################~^^^^^^^^^^^^^^^^^^^^^^^^^^^^^^^^^^^^^^
######################~^^^^^^^^^^^^^^^^^^^^^^^:;;$^^^^^:;$^^^
######################~^^^^^^^^^^^^^^^^^^^^^^^^^^^^^^^^^^^^^^
######################~^^^,$^^^^^^^^^^^^*
######################~^^^#^^^^^^^^^^^^:$
######################~^^^#^^^^^^^^E^^^^^^^^^^^^^^^^^^^,@$^^
######################~^^^#^^^^^:;;;;$^^^^^^^^^^^^^^^:;""";$
######################~^^^'
######################~^^^^^^^^^^:;;$^^^^^^^^^^^^|^^^^^^^^^^:
######################~^^^^^^^^^^^^^^^^^^^^^^^^^^^^^^^^^^^^^#
######################~^^^^^^^:;;;;;$^^^^^^^^^^:;;$^^^^^^^^^#
""""""""""""""""""""""`^^^^^^^^^^^^^^^^^^^^^^^^^^^^^^^^^^^^^#
^^^^^^^^^^^^^^^^^^^^^^^^^^^^^^^^^^^^^^^^^^^^^^^^^^^^^^^^^^^^#
^^^^^^^^^^^^^^^^^^^^^^^^^^^^^^^:@@$^^^^^^^^^^^^^^^^^^^E^^^^^#
@@@@@@@@@@@@@@@@@@@@@@@@@@@@@%%%###@@@@@@@@@@@@@@@@@@@@@@@@@#
#############################################################
#############################################################
#############################################################