-----------------------                                     
-----------------------                                     
-----------------------                           --        
-----------------------                                     
-----------------------                --                   
-----------------------                                     
-----------------------   --   --                           
-----------------------                                     
-----------------------                       ----     ---  
-----------------------                                     
-----------------------   --
-----------------------   -            --
-----------------------   -                            ---  
-----------------------   -     ------               -------
-----------------------   -
-----------------------          ---            |          -
-----------------------                                   -
-----------------------       -------         ----         -
--------------------==/                                    -
                                                    -
                                                           -
------------------------------%%----------------------------