-----------------------^^^^^^^^^^^^^^^^^^^^^^^^^^^^^^^^^^^^^
-----------------------^^^^^^^^^^^^^^^^^^^^^^^^^^^^^^^^^^^^^
-----------------------^^^^^^^^^^^^^^^^^^^^^^^^^^^--^^^^^^^^
-----------------------^^^^^^^^^^^^^^^^^^^^^^^^^^^^^^^^^^^^^
-----------------------^^^^^^^^^^^^^^^^--^^^^^^^^^^^^^^^^^^^
-----------------------^^^^^^^^^^^^^^^^^^^^^^^^^^^^^^^^^^^^^
-----------------------^^^--^^^--^^^^^^^^^^^^^^^^^^^^^^^^^^^
-----------------------^^^^^^^^^^^^^^^^^^^^^^^^^^^^^^^^^^^^^
-----------------------^^^^^^^^^^^^^^^^^^^^^^^----^^^^^---^^
-----------------------^^^^^^^^^^^^^^^^^^^^^^^^^^^^^^^^^^^^^
-----------------------^^^--^^^^^^^^^^^^^^^^^^^^^^^^^^^^^^^^
-----------------------^^^-^^^^^^^^^^^^--^^^^^^^^^^^^^^^^^^^
-----------------------^^^-^^^^^^^^^^^^^^^^^^^^^^^^^^^^--- ^
-----------------------^^^-^^^^^------^^^^^^^^^^^^^^^-------
-----------------------^^^-^^^^^^^^^^^^^^^^^^^^^^^^^^^^^^^^^
-----------------------^^^^^^^^^^---^^^^^^^^^^^^|^^^^^^^^^^-
-----------------------^^^^^^^^^^^^^^^^^^^^^^^^^^^^^^^^^^^^-
-----------------------^^^^^^^-------^^^^^^^^^----^^^^^^^^^-
--------------------==/^^^^^^^^^^^^^^^^^^^^^^^^^^^^^^^^^^^^-
^^^^^^^^^^^^^^^^^^^^^^^^^^^^^^^^^^^^^^^^^^^^^^^^^^^^-^^^^^^^
^^^^^^^^^^^^^^^^^^^^^^^^^^^^^^^----^^^^^^^^^^^^^^^^^^^^^^^^-
------------------------------%%----------------------------