-----------------------^^^^^^^^^^^^^^^^^^^^^^^^^^^^^^^^^^^^^^^^^^^^^^^^^^^^^^^^^^^^^^^^^^^---------^^^^^^^^^^^^^^^^^^^^^^-
-----------------------^^^^^^^^^^^^^^^^^^^^^^^^^^^^^^^^^^^^^^^^^^^^^^^^^^^^^^^^^^^^^^^^^^^^-%%%%%-^^^^^^^^^^^^^^^^^^^^^^^-
-----------------------^^^^^^^^^^^^^^^^^^^^^^^^^^^__^^^^^^^^^^^^^^^^^^^^^^^^^^^^^^^^^^^^^^^^-%%%-^^^^^^^^^^^^^^^^^^^^^^^^-
-----------------------^^^^^^^^^^^^^^^^^^^^^^^^^^^^^^^^^^^^^^^^^^^^^^^^^^^^^^^^^^^^^^^^^^^^^^-%-^^^^^^^^^^^^^^^^^^^^^^^^^-
-----------------------^^^^^^^^^^^^^^^^__^^^^^^^^^^^^^^^^^^^^^^^^^^^^^^^^^^^^^^^^^^^^^^^^^^^^^-^^^^^^^^^^^^^^^^^^^^^^^^^^-
------%----------------^^^^^^^^^^^^^^^^^^^^^^^^^^^^^^^^^^^^^^^^^^^^^^^^^^^^^^^^^^^^^^^^^^^^^^^^^^^^^^^^^^^^^^^^^^^^^^^^^^-
-----------------------^^^--^^^--^^^^^^^^^^^^^^^^^^^^^^^^^^^^^^^^^^^^^^^^^^^^^^^^^^^^^^^^^^^^^^^^^^^^^^^^^^^^^^^^^^^^^^^^-
-----------------------^^^^^^^^^^^^^^^^^^^^^^^^^^^^^^^^^^^^^^^^^^^^^^*^^^^^^^^^^^^^^^^^^^^^^^^^^^^^^^^^^^^^^^^^^^^^^^^^^^-
-----------------------^^^^^^^^^^^^^^^^^^^^^^^----^^^^^?_\^^^^^^^^^^^^^^^^^^^^^^^^^^^^^^^^^^^^^^^^^^^^^^^^^^^^^^^^^^^^^^^-
-----------%-----------^^^^^^^^^^^^^^^^^^^^^^^^^^^^^^^^^^^^^^^^^^^^^^_^^^^^^^__^^^^^^^^^^^^^^^^^^^^^^^^^^^^^^^^^^^^^^^^^^-
-----------------------^^^__^^^^^^^^^^^^^^^^^^^^^^^^^^^^^^^^^^^^^^^^^^^^^^^^^^^^^^^^^^^^^^^^^^^^^^^^^^^^^^^^^^^^^^^^^^^^^-
-----------------------^^^-^^^^^^^^^^^^?\^^^^^^^^^^^^^^^^^^^^^^^^^^^^^^^^^^^^^^^^^^^^^^^^^^^^^^^^^^^^^^^^^^^^^^^^^^^^^^^^-
-----------------------^^^-^^^^^^^^^^^^^^^^^^^^^^^^^^^^---^^^^^^^^^^^^^^^^^^^^^^^^^^^^^^^^^^^^^^^^^^^^^^^^^^^^^^^^^^^^^^^-
-----------------------^^^-^^^^^------^^^^^^^^^^^^^^^-------^^^^^^^^^^^^^^^^^^^^^^^^^--^^^^^^^^^^^^^^^^^^^^^^^^^^^^^^^^^^-
---------%-------------^^^-^^^^^^^^^^^^^^^^^^^^^^^^^^^^^^^^^^^^^^^^^^^^^^^^^^^^^^^^^^^^^^^^^^|^^^^^^^^^^^^^^^^^^^^^^^^^^^-
-----------------------^^^^^^^^^^---^^^^^^^^^^^^^^^^^^^^^^^_^^^^^^^^^^^^^^^^^^^^^^^^^^^^^^^^^^^^^^^^^^^^^^^^^^^^^^^^^^^^^-
-----------------------^^^^^^^^^^^^^^^^^^^^^^^^^^^^^^^^^^^^-^^^^^^^^^^^^^^^^^^^^^^^^^^^^^^^--_-____-^^^^^^^^^^^^^^^^^^^^^-
-----------------------^^^^^^^?_____\^^^^^^^^^----^^^^^^^^^-^^^^^^^^^^^^^^^^^^^^^^^^^^^^^^-^^^^^^^^^-^^^^^^^^^^^^^^^^^^^^-
-------------^^^^^^----^^^^^^^^^^^^^^^^^^^^^^^^^^^^^^^^^^^^-^^^^^^^^^^^^^^^^^^^^^^^^^^^^^-^^^^^^^^^^^-^^^^^^^^^^^^^^^^^^^-
^^^^^^^^^^^^^^^^^^^^^^^^^^^^^^^^^^^^^^^^^^^^^^^^^^^^_^^^^^^^^^^^^^^^^^^^^^^^^^^^^^^^^^^^-^^^^^^^^^^^^^-^^^^^^^^^^^^^^^^^^-
^^^^^^^^^^^^^^^^^^^^^^^^^^^^^^^^^^^^^^^^^^^^^^^^^^^^^^^^^^^^^^^^^^^^^^^^^^^^^^^^^^^^^^^-^^^^^^^^^^^^^^^-^^^^^^^^^^^^^^^^^-
----------------^-------------^^------------------------------------------------------------------------------------------
--------------------------------------------------------------------------------------------------------------------------
--------------------------------------------------------------------------------------------------------------------------
--------------------------------------------------------------------------------------------------------------------------