-----------------------^^^^^^^^^^^^^^^^^^^^^^^^^^^^^^^^^^^^^
-----------------------^^^^^^^^^^^^^^^^^^^^^^^^^^^^^^^^^^^^^
-----------------------^^^^^^^^^^^^^^^^^^^^^^^^^^^()^^^^^^^^
-----------------------^^^^^^^^^^^^^^^^^^^^^^^^^^^^^^^^^^^^^
-----------------------^^^^^^^^^^^^^^^^()^^^^^^^^^^^^^^^^^^^
-----------------------^^^^^^^^^^^^^^^^^^^^^^^^^^^^^^^^^^^^^
-----------------------^^^()^^^()^^^^^^^^^^^^^^^^^^^^^^^^^^^
-----------------------^^^^^^^^^^^^^^^^^^^^^^^^^^^^^^^^^^^^^
-----------------------^^^^^^^^^^^^^^^^^^^^^^^-]]-^^^^^-])^^
-----------------------^^^^^^^^^^^^^^^^^^^^^^^^^^^^^^^^^^^^^
-----------------------^^^?\^^^^^^^^^^^^*
-----------------------^^^[^^^^^^^^^^^^?\
-----------------------^^^[^^^^^^^^^^^^^^^^^^^^^^^^^^^^?_\^^
-----------------------^^^[^^^^^(]]]])^^^^^^^^^^^^^^^?_---_\
-----------------------^^^{
-----------------------^^^^^^^^^^(]\)^^^^^^^^^^^^|^^^^^^^^^^-
-----------------------^^^^^^^^^^^^^^^^^^^^^^^^^^^^^^^^^^^-
-----------------------^^^^^^^(]]]]])^^^^^^^^^(]])^^^^^^^^^-
======================/^^^^^^^^^^^^^^^^^^^^^^^^^^^^^^^^^^^^-
^^^^^^^^^^^^^^^^^^^^^^^^^^^^^^^^^^^^^^^^^^^^^^^^^^^^-
^^^^^^^^^^^^^^^^^^^^^^^^^^^^^^^----^^^^^^^^^^^^^^^^^^^^^^^^-
------------------------------%%----------------------------
------------------------------------------------------------
------------------------------------------------------------
------------------------------------------------------------